00000000000
01000000010
01011111110
01000100010
01111100110
01000100100
00010100100
01111110110
01010000010
01111111110
00000000000